*
*
*
BBBBBBBBBBBBF   DBBBBBBBBBBB
*
*
BBBBBBBBBBBBBBBBBBBBF    DBB
*
*
BBBBBBBBBBBF                
                 DBBBBBBBBBF
               DBAAAGHHHHGAE
             DBAAAAGHH bHHGE
           DBAAAAAAGHH  HHGE
         DBAGGGAAAAGGHHHHGGE
       DBAAGHHHGAAAAGGGGGGAE
     DBAAAAH   HGAAAAAAAAAAE
          DH               H
          DH    b           
BBBB      DH                
          DH   HHH     b    
      BBBBDH                
          DH     b    HHH   
BBBB      DH                
          DH    HHH         
          DH           b    
   BBBBBBBDH                
          DH    b     HHH   
          DH                
          DH   HHH          
B         DH                
AB       DDHHHHHHHHHHHHHHHHH
AAB  BBBBAAAGGGGGGGHGGHGGGGG
         AAGGGGH b HAAH b HG
BBB      AGGGGGH   HAAH   HG
AAABBB   GGGGGGGGGGHGGHGGGGG
         BBBBBBBBBBHBBHBBBBB
*
*
AAAAAAAAAAAAAAA     DBBBBBBF
          b                 
*
BBBB@@BBBBBBBBBBBBBBBBBBBBBB
